%%%%%%%%%%%%%%%%%%%%%%%%%%%%%%%%%%%%%%%%%%%%%%%%%%%%%%%%%%
%                                                       P%
%      %%%%%                 %         %     %%%%%%%     %
%      %                     %        % %       %        %
%      %%%%   %   %   %%%%   % %     %%%%%      %        %
%      %      %   %   %      %%     %     %     %        %
%      %      %%%%%   %%%%   % %   %       % %%%%%%%     %
%.                                                       %
%%%%%%%%%%%%%%%%%%%%%%%%%%%%%%%%%%%%%%%%%%%%%%%%%%%%%%%%%%