%%%%%%%%%%%%%%%%%%%%%%%%%%%%%%%%%%%%%%%%%%%%%%%%%%%%%%%%%%
%                                                       P%
%                                                        %
%                                                        %
%                                                        %
%                                                        %
%                                                        %
%                                                        %
%                                                        %
%                                                        %
%                                                        %
%                                                        %
%                                                        %
%                                                        %
%                                                        %
%                                                        %
%                                                        %
%                                                        %
%                                                        %
%                                                        %
%.                                                       %
%%%%%%%%%%%%%%%%%%%%%%%%%%%%%%%%%%%%%%%%%%%%%%%%%%%%%%%%%%