%%%%%%%%%%%%%%%%%%%%%%%%%%%%%%%%%%%%%%%%%%%%%%%%%%%%%%%%%%%%%%%%
%                                                             P%
%                                                              %
%                                                              %
%                                                              %
%                                                              %
%                                                              %
%                                                              %
%                                                              %
%                                                              %
%                                                              %
%                                                              %
%                                                              %
%                                                              %
%                                                              %
%                                                              %
%                                                              %
%                                                              %
%                                                              %
%                                                              %
%.                                                             %
%%%%%%%%%%%%%%%%%%%%%%%%%%%%%%%%%%%%%%%%%%%%%%%%%%%%%%%%%%%%%%%%