%%%%%%%%%%%%%%%%%%%%%%%%%%%%%%%%%%%%%
% %   %   %                        P%
% % % % % %  %%%%%%  %%%%%%%%%%%%%% %
% % % % % %  %    %%%%%%%%%%%%%%%%% %
% % % % % %  %    %                 %
% % % % % %  %                      %
% % % % % %  %   %%%%               %
% % % % % %  %   %  %               %
% % % % % %  %   %  %               %
% % % % % %  %   %  %               %
% % % % % %  %   %  %               %
% % % % % %  %   %  %               %
% % % % % %  %%%%%  %               %
%   %   %           %               %
%%%%%%%%%%%%%%%%%%% %%%%%%%%%%%%%%%%%
%            %    %                 %
%            %    %%%%%%%%%%%%%%%%% %
%            %                      %
%            %                      %
%             %%%%%%%%%%%%%%%%%%%%% %
%                                   %
%.                                  %
%%%%%%%%%%%%%%%%%%%%%%%%%%%%%%%%%%%%%