%%%%%%%%%%%%%%%%%%%%%%%%%%%%%%%%%%%%%%%%%%%%%%%%%%%%%%%%%%
%                                                       %
%      %%%%%%                %         %     %%%%%%%     %
%      %                     %        %P%       %        %
%      %%%%   %   %    %%%   % %     %%%%%      %        %
%      %      %   %   %      %%     %     %     %        %
%      %       %%%     %%%   % %   %       % %%%%%%%     %
%                                                        %
%%%%%%%%%%%%%%%%%%%%%%%%%%%%%%%%%%%%%%%%%%%%%%%%%%%%%%%%%%                                                      